2 13 31
###############################
#p   s*            3          #
#***b**          5            #
#     #    ****************   #
#          *       1      * 4 #
#     #    *    *******   *   #
#     1    * 1  *  y  *   *   #
#     #    *    *******   *   #
#     1    *       4      *   #
#     #    ****************   #
#                   5         #
#              3              #
###############################