5 13 31
###############################
#p * *3       *  ** * *      *#
# # # # #*# # #*# # # # # #*# #
#    * * *** **  3   *    **  #
# #*# # # # #4# #b#1# # # # #*#
#     1    *     **      *  **#
# # #*# # # # # #*#*#*#*# # # #
#   *   1    *   * *x* *   3  #
# # # # #*# # # # # # #*# #*# #
#   ****         *2           #
# # # # # # # # # #*# # # # #*#
#  ** *1  *    2              #
###############################