2 13 31
###############################
#p   s*            3          #
#***b**                       #
#     #    ****************   #
#          *       1      *   #
#     #    *    *******   *   #
#     1    * 1  *  y  *   *   #
#     #    *    *******   *   #
#     1    *       2      *   #
#     #    ****************   #
#                             #
#              3              #
###############################